
....,....,....,....,....,....,
         ----------------    .
        |                |   .
 -------5-------3-----1  |   .
|               |     |  |   .
6-------0-------4     |  |   ,
|              /|     |  |   .
|             / 2-----   |   .
 --7---------   |        |   .
                 --------    .
                             ,